############################
#............##............#
#.####.#####.##.#####.####.#
#..........................#
#.####.##.########.##.####.#
#......##....##....##......#
######.##### ## #####.######
     #.##          ##.#     
     #.## ######## ##.#     
######.## #      # ##.######
      .   #      #   .      
######.## #      # ##.######
     #.## ######## ##.#     
     #.##          ##.#     
######.## ######## ##.######
#............##............#
#.####.#####.##.#####.####.#
#...##................##...#
###.##.##.########.##.##.###
#......##....##....##......#
#.##########.##.##########.#
############################