############################
#                          #
# ## ################## ## #
# ## ################## ## #
#            ##            #
# ## ####### ## ####### ## #
# ##                    ## #
# ## ## ############ ## ## #
# ## ##              ## ## #
# ## ## #####  ##### ## ## #
#    ## #          # ##    #
        #          #        
# ##    #          #    ## #
# ##    ############    ## #
# ## ##              ## ## #
# ## ## ############ ## ## #
# ##                    ## #
#    ####### ## #######    #
#            ##            #
# ## ################## ## #
#                          #
############################