############################
#                          #
# #### #### ##### ### #### #
# #### #### ##### ### #### #
#                          #
# #### ## ######## ## #### #
#      ##    ##    ##      #
###### ##### ## ##### ######
###### ##          ## ######
###### ## ###  ### ## ######
          #      #          
###### ## ######## ## ######
###### ##          ## ######
###### ## ######## ## ######
#            ##            #
# #### ##### ## ##### #### #
# #### ##### ## ##### #### #
#                          #
# #### ####  ## #### ##### #
# #### ####  ## #### ##### #
#                          #
############################