############################
#..........................#
#.####.###.######.####.###.#
#.####.###.######.####.###.#
#..........................#
#.###.###.########.###.###.#
#.###.###.########.###.###.#
#.....###....##....###.....#
#####.######.##.######.#####
#####.######.##.######.#####
#####.###..........###.#####
#####.###.###  ###.###.#####
..........#      #..........
#####.###.#      #.###.#####
#####.###.########.###.#####
#####.###..........###.#####
#####.###.########.###.#####
#####.###....##....###.#####
#............##............#
#.###.######.##.######.###.#
#..........................#
#.###.###.########.###.###.#
#.###.###.########.###.###.#
#..........................#
############################
############################
