############################
#..........................#
#.###.################.###.#
#.###.################.###.#
#...........####...........#
#.###.#####.####.#####.###.#
#.###.#####.####.#####.###.#
#.###..................###.#
#.###.##.##########.##.###.#
#.###.##.##########.##.###.#
#.###.##............##.###.#
#.###.##.####  ####.##.###.#
......##.##      ##.##......
#.###.##.##      ##.##.###.#
#.###....##########....###.#
#.###.##............##.###.#
#.###.##.##########.##.###.#
#.###.##.##########.##.###.#
#.###..................###.#
#.###.#####..##.######.###.#
#.###.#####..##.######.###.#
#............##............#
#.###.################.###.#
#.###.################.###.#
#..........................#
############################
